11111111111111
101Z00CC00PC01
10C0Z000C00011
11000000100011
1EC0ZC0000C0Z1
11111111111111