111111111111111111
101Z0C000100Z0C0C1
1Z0Z0C0CC0Z0CP0011
1100010CC000100011
1Z00CZ0E0Z0C0Z0001
111111111111111111