111111111111111111
1P1000000100000001
100000000000000011
110001000000100011
10000C0E0000000001
111111111111111111