1111111111111111111
1Z0C0000C00Z00C1001
10010111110000010Z1
1Z010C0ZC00C0P01001
100100Z00C000EC1001
10C011Z11011CZC00C1
1111111111111111111