1111111111111111111
1E10000000000000001
1010001000100010101
1010001000100010101
1P000000000000000C1
1111111111111111111