111111111111111111
1Z100C0001Z000C0C1
100Z0C0CC0Z0CP0011
110Z010CC000100Z11
10Z0C0ZE0Z0C00Z001
111111111111111111