111111111111111111
10100C00010000C0C1
10000C0CC000CP0011
1100010CC000100011
1000C00E000C000001
111111111111111111