11111111111111111
1Z100C0C100C0C0P1
100Z00C00Z00C0011
1100C10C00C10CZ01
10Z00CZCZ00C0CEZ1
11111111111111111